33
30
WWWWWWWWWWWWWWWWWWWWWWWWWWWWWW
WWWWWWWWWWWWWWWWWWWWWWWWWWWWWW
WWPPPPPPPPPPPPWWPPPPPPPPPPPPWW
WWPWWWWPWWWWWPWWPWWWWWPWWWWPWW
WWBWWWWPWWWWWPWWPWWWWWPWWWWBWW
WWPWWWWPWWWWWPWWPWWWWWPWWWWPWW
WWPPPPPPPPPPPPPPPPPPPPPPPPPPWW
WWPWWWWPWWPWWWWWWWWPWWPWWWWPWW
WWPWWWWPWWPWWWWWWWWPWWPWWWWPWW
WWPPPPPPWWPPPPWWPPPPWWPPPPPPWW
WWWWWWWPWWWWWwWWwWWWWWPWWWWWWW
WWWWWWWPWWWWWwWWwWWWWWPWWWWWWW
WWWWWWWPWWwwwwwwwwwwWWPWWWWWWW
WWWWWWWPWWwWWWwwWWWwWWPWWWWWWW
WWWWWWWPWWwWWWwwWWWwWWPWWWWWWW
WWwwwwwPwwwWWHHHHWWwwwPwwwwwWW
WWWWWWWPWWwWWWWWWWWwWWPWWWWWWW
WWWWWWWPWWwWWWWWWWWwWWPWWWWWWW
WWWWWWWPWWwwwwwwwwwwWWPWWWWWWW
WWWWWWWPWWwWWWWWWWWwWWPWWWWWWW
WWWWWWWPWWwWWWWWWWWwWWPWWWWWWW
WWPPPPPPPPPPPPWWPPPPPPPPPPPPWW
WWPWWWWPWWWWWPWWPWWWWWPWWWWPWW
WWPWWWWPWWWWWPWWPWWWWWPWWWWPWW
WWBPPWWPPPPPPPPSPPPPPPPWWPPBWW
WWWWPWWPWWPWWWWWWWWPWWPWWPWWWW
WWWWPWWPWWPWWWWWWWWPWWPWWPWWWW
WWPPPPPPWWPPPPWWPPPPWWPPPPPPWW
WWPWWWWWWWWWWPWWPWWWWWWWWWWPWW
WWPWWWWWWWWWWPWWPWWWWWWWWWWPWW
WWPPPPPPPPPPPPPPPPPPPPPPPPPPWW
WWWWWWWWWWWWWWWWWWWWWWWWWWWWWW
WWWWWWWWWWWWWWWWWWWWWWWWWWWWWW