10
10
WWWWWWWWWW
WPPPSPPPPW
WPPPPPPPPW
WPPPPPPPPW
WPPPPPPPPW
WPPPPPPPPW
WPPPPPPPPW
WPPPPPPPPW
WPPHHHHPPW
WWWWWWWWWW